12
22
   XXXXXXXXXXXXXXXXXXX
XX               XXXXX
XXXXX XXXXXXXX XXXXXXX
XXXXX XXXXXXXX       X
XXXXX          XXXXXXX
XXX   XXXXXXXX XXXXXXX
XXXXXXXX           XXX
XXX      XXXXXXXXXXXXX
XXX XXXX XXXXXXXXXXXXX
XXX XXXX           XXX
XXXXXX   XXXXXXXXX$XXX
XXXXXXXXXXXXXXXXXXXXXX