10
10
XXXXXXXXXX
X        X
XXXX XXXXX
XXXX XXXXX
XX      XX
XXX X X XX
X   X X  X
XXXXX XXXX
XX     $XX
XXXXXXXXXX